R 500 500

C 69,231,160
F 231,160,52

NO ./textures/wood_wall.xpm
SO ./textures/wood_wall2.xpm
EA ./textures/red_brick.xpm
S ./textures/barrel.xpm	
WE ./textures/dalles.xpm

111111111111111111111111
100000222000000000000001
100000000000000000000001
100000110110000000000001
100000000000000000000001
100000000000000000N00001
100000000000000000000001
100000000000000000000001
100000000000000000000001
100000000000000000000001
100000020202000000000001
122222222222222000000001
100000020202000000000001
100000000000000000000011
1000000000000000000000011111
111100000000011111111111
111111111000000000000001
111111111111111111111111
111111111111111
