R 1000				1000  		

C 69,231,160
F 231,160,69					

NO ./textures/wood_wall.xpm
SO ./textures/wood_wall2.xpm
WE ./textures/dalles.xpm
EA ./textures/red_brick.xpm
S hey

11111111111111111
10000000000000001
10000000000000001
10000000010000001
10000000000000001
10000000000000001
10000000000000001
10000000000000001
10000000000000001
10000000000000001
10000000000000001
10000000000000001
100000000N0000001
10000000000000001
10000000000000001
10000000000000001
10000000000000001
10000000000000001
10000000000000001
10000000000000001
10000000000000001
10000000000000001
10000000000000001
10000000000000001
10000000000000001
11111111111111111

11111111111111111
10000000000000001
11111111111111111
