R 1000 1000

C 69,231,160
F 231,160,69

NO jeythshdtjuykuytjjjj
SO ahthztrhtyjgyeuryuju
WE egzrg
EA trh
S hey

11111111111111111
10000000000000001
10000000000000001
10000000010000001
10000000000000001
10000000000000001
10000000000000001
10000000000000001
10000000000000001
10000000000000001
10000000000000001
10000000000000001
100000000S0000001
10000000000000001
10000000000000001
10000000000000001
10000000000000001
10000000000000001
10000000000000001
10000000000000001
10000000000000001
10000000000000001
10000000000000001
10000000000000001
10000000000000001
11111111111111111