R 1000	1000  		

C 69,231,160
F 231,160,69					

NO ./textures/wood_wall.xpm
SO ./textures/wood_wall2.xpm
WE ./textures/dalles.xpm
EA ./textures/red_brick.xpm
S ./textures/barrel.xpm

111111111    111111111
1000000011111111111111
10000000000000001
10000000000000001
10000000010000001
10000000000000001
10000000000000001
10000000000000001
10000000000000001
10000002222000001
10000000000000001
10000000000000001
10000000N00000001
10000000002000001
11111111111111111
11111111111111111
11111111111110111
10000000000000001
10000220000000001
10000000000000001
10000000000000001
100000001111111111
100000000011
10000000011
11111111111


